																																																																																																																												
																																																																																																																												
																																																																																																																												
																																																																																																																												
																																																																																																																												
																																																																																																																												
2	2	2	2	2	2	1	2	2	2	2	2	2	2	2		2	2	2	2	2	2	2	2	2	2	2	2	2	2	2	2	2	2	2	2	2	4	5	2																																																																																					
1	2	3	1	3	1	3	1	2	3	1	2	13	14	15	16	17	18	13	14	15	13	14	15	16	130	131	131	131	132	133	134	135	13	14	15	46	47	48	1	2	2	2	2	2																																																																															1	2	3
1											1	23	24	25	26	27	28	23	24	25	23	24	25	26	140	141	141	141	142	143	144	145	23	24	25	56	57	58							2	2	2	2																																																																												
1											1	33	34	35	36	37	38	33	34	35	33	34	35	36	140	141	141	141	142	153	154	155	33	34	35	66	67	68											2	2	2	2																																																																								
1											1	10	11	12	10	11	12	10	11	12	10	11	12	10	140	141	141	141	142	10	11	12	10	11	12	76	77	78															2	2	2																																																																					
1											1	20	21	22	8	21	22	20	21	22	20	21	22	20	140	141	141	141	142	20	21	22	20	21	22	86	87	88																		2	2																																																																			
1											1	30	31	32	30	31	32	30	31	32	30	31	32	30	150	151	151	151	152	30	31	32	30	31	32	96	97	98										2	2	2							2	2																																																																				1	2	3
1											1	3	1	2	3	1	2	3	1	2	3	1	2	3	3	1	2	4	5	1	2	3	1	2	3	1	1	1	1	1	1																	2	2																																																																	
1											1	40	41	42	40	41	42	40	41	42	40	41	42	43	44	45	46	47	48	40	41	42	43	44	45	40	41	42	1		1	1	1	1															2	2																																																																
1											1	50	51	52	50	51	52	50	51	52	50	51	52	53	54	55	56	57	58	50	51	52	53	54	55	50	51	52	1					1	1	1	2	2																																																																												
1											1	60	61	62	60	61	62	60	61	62	60	61	62	63	64	65	66	67	68	60	61	62	63	64	65	60	61	62	1									2	2															130	131	132	130	132																																																													1	2	3
1											1	70	71	72	70	71	72	73	74	75	70	71	72	73	74	75	76	77	78	70	71	72	70	71	72	70	71	72	1											2	2													140	141	142	150	152																																																								
1											1	80	81	82	80	81	82	83	84	85	80	81	82	83	84	85	86	87	88	80	81	82	80	81	82	80	81	82	1													2	2	2										140	141	142	130	132																																																								
1											1	90	91	92	90	91	92	93	94	95	90	91	92	93	94	95	96	97	98	90	91	92	90	91	92	90	91	92	1																									150	151	152	150	152																																																								
1	1	1	1	1	1	1	1	1	1	1	1	1	1	1	1	1	1	1	1	1	1	1	1	1	1	1	1	1	1	1	1	1	1	1	1	1	1	1	1	1	1	1	1	1	1	1	1	1	1	1	1	1	1	1	1	1	1	1	1	1	1	1	1	1	1	1	1	1	1	1	1	1	1	1	1	1	1	1	1	1	1	1	1	1	1	1	1	1	1	1	1	1	1	1	1	1	1	1	1	1	1	1	1	1	1	1	1	1	1	1	1	1	1	1	1	1	1	1	1	1	1	1	1	1	1	1	1	1	1	1	1	1	1	1	1
1																																																																																																																												
1																																																																																																																												
1																																																																																																																												
										

								


								


										


								



										

										
										




										
									
										




										
										

										



									
										

										
										
										


										



										


										

										




										
										





										




										

										





											
												





										
										






										
										






										







										






										






										







										






										





										













										






										







										







										






										






										






										